#;#;#;#;#;#;#;#;#;#;#;#;#;#;#;#;#;#;#;#;#;#;#;#;#;#;#;#
#; ; ; ; ; ; ; ; ; ; ; ; ; ; ; ; ; ; ; ; ; ; ; ; ; ; ;#
#; ; ; ; ; ; ; ; ; ; ; ; ; ; ; ; ; ; ; ; ; ; ; ; ; ; ;#
#; ; ; ; ; ; ; ; ; ; ; ; ; ; ; ; ; ; ; ; ; ; ; ; ; ;Transition|v|2;#
#; ; ; ; ; ; ; ; ; ; ; ; ; ; ; ; ; ; ; ; ; ; ; ; ; ; ;#
#; ; ; ; ; ; ; ; ; ; ; ; ; ; ; ; ; ; ; ; ; ; ; ; ; ; ;#
#; ; ; ; ; ; ; ; ; ;*;*;*;*;*;*;*;*;*;*;*;*;*;*;*;*;*;#
#; ; ; ; ; ; ; ; ; ;*;#;#;#;#;#;#;#;#;#;#;#;#;#;#;#;#;#
#; ; ; ; ; ; ; ; ; ; ; ; ; ; ; ; ; ; ; ;#;#;#;#;#;#;#;#
#; ; ; ; ; ; ; ; ; ; ; ; ; ; ; ; ; ; ; ; ; ; ; ; ;#;#;#
#; ; ; ; ; ; ; ; ; ; ; ; ; ; ; ; ; ; ; ; ; ; ; ; ; ;#;#
#; ; ; ;*;*;*;*;*; ; ; ; ; ; ; ; ; ; ; ; ; ; ; ; ; ;#;#
#; ; ; ;*;#;#;#;*; ; ; ; ; ; ; ; ; ; ; ; ; ; ; ; ; ; ;#
#; ; ; ; ; ; ; ; ; ; ; ; ; ; ; ; ; ; ; ; ; ; ; ; ; ; ;#
#; ; ; ; ; ; ; ; ; ; ; ; ; ; ; ; ; ; ; ; ; ; ; ; ; ; ;#
#; ; ; ; ; ; ; ; ; ;*;*;*;*;*;*;*;*;*; ; ; ; ; ; ; ; ;#
#; ; ; ; ; ; ; ; ; ;*;#;#;#;#;#;#;#;*; ; ; ; ; ; ; ;#;#
#; ; ; ; ; ; ; ; ; ; ; ; ; ; ; ; ; ; ; ; ; ; ; ; ; ;#;#
#; ; ; ; ; ; ; ; ; ; ; ; ; ; ; ; ; ; ; ; ; ; ; ; ; ;#;#
#; ; ; ; ; ; ; ; ; ; ; ; ; ; ; ; ; ; ; ; ; ; ; ; ; ;#;#
#; ; ; ; ; ; ; ; ; ; ; ; ; ; ; ; ; ; ; ; ; ; ; ; ; ;#;#
#; ; ; ; ; ; ; ; ; ; ; ; ; ; ; ; ; ; ; ;*;*;*;*;*;*;#;#
#; ; ; ; ; ; ; ; ; ; ; ; ; ; ; ; ; ; ; ;*;#;#;#;#;#;#;#
#; ; ; ; ; ; ; ; ; ; ; ; ; ; ; ; ; ; ; ;*;#; ; ;Transition|h|5; ; ;#
#; ; ; ; ; ; ; ; ; ; ; ; ;*;*;*;*;*; ; ;*;#; ; ; ; ; ;#
#; ; ; ; ; ; ; ; ; ; ; ; ;*;#;#;#;*; ; ;*;#; ; ; ; ; ;#
#; ; ; ; ; ; ; ; ; ; ; ; ; ; ; ; ; ; ; ; ; ; ; ; ; ; ;#
#;Transition|v|bvz; ; ; ; ; ; ; ; ; ; ; ; ; ; ; ; ; ; ; ; ; ; ; ; ; ;#
#; ; ; ; ; ; ; ; ; ; ; ; ; ; ; ; ; ; ; ; ; ; ; ; ; ; ;#
#; ; ; ;@; ; ; ; ; ; ; ; ; ; ; ; ; ; ; ; ; ; ; ; ; ; ;#
#;*;*;*;*;*;*;*;*;*;*;*;*;*;*;*;*;*;*;*;*;*;*;*;*;*;*;#
#;#;#;#;#;#;#;#;#;#;#;#;#;#;#;#;#;#;#;#;#;#;#;#;#;#;#;#
