#;#;#;#;#;#;#;#;#;#;#;#;#;#;#;#;#;#;#;#;#;#;#;#;#;#;#;#;#;#;#;#;#;#;#;#;#;#;#;#;#;#;#;#;#;#;#;#;#;#;#;#;#;#;#;#;#;#;#;#;#;#;#;#;#;#;#;#;#
#;#;#; ; ; ; ; ; ; ; ; ; ; ; ; ; ;s;s;s;s;s; ; ; ; ; ; ; ;#;#;#; ; ; ; ; ; ;s;s;s; ; ; ; ;#;#;#;#;#;#;#;#;#;#;#;#;#;#;#;#;#;#;#;#;#;#;#;#
#;#;#; ; ; ; ; ; ; ; ; ; ; ; ; ; ; ; ; ; ; ; ; ; ; ; ; ; ;s;s;s; ; ; ; ; ; ; ; ; ; ; ; ; ; ; ; ; ; ;#;#;#;#;#;#;#;#;#;#;#;#;#;#;#;#;#;#;#
#;#;#; ; ; ; ; ; ; ; ; ; ; ; ; ; ; ; ; ; ; ; ; ; ; ; ; ; ; ; ; ; ; ; ; ; ; ; ; ; ; ; ; ; ; ; ; ; ; ; ; ; ; ; ; ; ;#;#;#;#;#;#;#;#;#;#;#;#
#;#;#; ; ; ; ; ; ; ; ; ; ; ; ; ; ; ; ; ; ; ; ; ; ; ; ; ; ; ; ; ; ; ; ; ; ; ; ; ; ; ; ; ; ; ; ; ; ; ; ; ; ; ; ; ; ; ; ; ; ; ; ; ;#;#;#;#;#
#;#;#; ; ; ; ; ; ; ; ; ; ; ; ; ; ; ; ; ; ; ; ; ; ; ; ; ; ; ; ; ; ; ; ; ; ; ; ; ; ; ; ; ; ; ; ; ; ; ; ; ; ; ; ; ; ; ; ; ; ; ; ; ; ; ; ; ;#
#;#;#; ; ; ; ; ; ; ; ; ; ; ; ; ; ; ; ; ; ; ; ; ; ; ; ; ; ; ; ; ; ; ; ; ; ; ; ; ; ; ; ; ; ; ; ; ; ; ; ; ; ; ; ; ; ; ; ; ; ; ; ; ; ; ; ; ;#
#;#;#; ; ; ; ; ; ; ; ; ; ; ; ; ; ; ; ; ; ; ; ; ; ; ; ; ; ; ; ; ; ; ; ; ; ; ;s;s;s; ; ; ; ; ; ; ; ; ; ; ; ; ; ; ; ; ; ; ; ; ; ; ; ; ; ;Transition|v|4;#
#;#;#; ; ; ; ; ; ; ; ; ; ; ; ; ; ; ; ; ; ; ; ; ; ; ; ; ; ;s;s;s; ; ; ; ; ; ;#;#;#; ; ; ; ; ; ; ; ; ; ; ; ; ; ; ; ; ; ; ; ; ; ; ; ; ; ; ;#
#;#;#; ; ; ; ; ; ; ; ; ; ; ; ; ; ;s;s;s;s;s; ; ; ; ; ; ; ;#;#;#; ; ; ; ; ; ;#;#;#; ; ; ; ; ; ; ; ; ; ; ; ; ; ; ; ; ; ; ; ; ; ; ; ; ; ; ;#
#;#;#; ; ; ; ; ; ; ; ; ; ;#;#;#;#;#;#;#;#;#;#;#;#;#;#;#;#;#;#;#;#;#;#;#;#;#;#;#;#;#;#;#;#;#;#;#;#;#;#;#;#;#;#;#;#;#;#;#;#;#;#;#;#;#;#;#;#
#;#;#; ; ; ; ; ; ; ; ; ;#;#;#;#;#;#;#;#;#;#;#;#;#;#;#;#;#;#;#;#;#;#;#;#;#;#;#;#;#;#;#;#;#;#;#;#;#;#;#;#;#;#;#;#;#;#;#;#;#;#;#;#;#;#;#;#;#
#;#;#; ; ; ; ; ; ; ;#;#;#;#;#;#;#;#;#; ; ; ; ; ; ; ; ; ; ; ; ; ; ; ; ; ; ; ; ; ; ; ; ; ; ; ; ; ; ;#;#;#;#;#;#;#;#;#;#;#;#;#;#;#;#;#;#;#;#
#;#;#; ; ; ; ; ; ; ;#;#;#;#;#; ; ; ; ; ; ; ; ; ; ; ; ; ; ; ; ; ; ; ; ; ; ; ; ; ; ; ; ; ; ; ; ; ; ; ; ;#;#;#;#;#;#;#;#;#;#;#;#;#;#;#;#;#;#
#;#;#; ; ; ; ; ; ; ; ; ; ; ; ; ; ; ; ; ; ; ; ; ; ; ; ; ; ; ; ; ; ; ; ; ; ; ; ; ; ; ; ; ; ; ; ; ; ; ; ; ; ;#;#;#;#;#;#;#;#;#;#;#;#;#;#;#;#
#;#;#; ; ; ; ; ; ; ; ; ; ; ; ; ; ; ; ; ; ; ; ; ; ; ; ; ; ; ; ; ; ; ; ; ; ; ; ; ; ; ; ; ; ; ; ; ; ; ; ; ; ; ;#;#;#;#;#;#;#;#;#;#;#;#;#;#;#
#;#;#; ; ; ; ; ; ; ; ; ; ; ; ; ; ; ; ; ; ; ; ; ; ; ; ; ; ; ; ; ; ; ; ; ; ; ; ; ; ; ; ; ; ; ; ; ; ; ; ; ; ; ; ;#;#;#;#;#;#;#;#;#;#;#;#;#;#
#;#;#; ; ; ; ; ; ; ; ; ; ; ; ; ; ; ; ; ; ; ; ; ; ; ; ; ; ; ; ; ; ; ; ; ; ; ; ; ; ; ; ; ; ; ; ; ; ; ; ; ; ; ; ;#;#;#;#;#;#;#;#;#;#;#;#;#;#
#;#;#;#;#;#;#;#;#; ; ; ; ; ; ; ; ; ; ; ; ; ; ; ; ; ; ; ; ; ; ; ; ; ; ; ; ; ; ; ; ; ; ; ; ; ; ; ; ; ; ; ; ; ; ;#;#;#;#;#;#;#;#;#;#;#;#;#;#
#;#;#;#;#;#;#;#;#; ; ; ; ; ; ; ; ; ; ; ; ; ; ; ; ; ; ; ; ; ; ; ; ; ; ; ; ; ; ; ; ; ; ; ; ; ; ; ; ; ; ; ; ; ; ;#;#;#;#;#;#;#;#;#;#;#;#;#;#
#;#;#;#;#;#; ; ; ; ; ; ; ; ; ; ; ; ; ; ;s;s;s;s;s;s;s; ; ; ; ; ; ; ; ; ; ; ; ; ; ; ; ; ; ; ; ; ; ; ; ; ; ; ; ;#;#;#;#;#;#;#;#;#;#;#;#;#;#
#;#;#;#; ; ; ; ; ; ; ; ; ; ; ;#;#;#;#;#;#;#;#;#;#;#;#;#;#;#;#;#; ; ; ; ; ; ; ; ; ; ; ; ; ; ; ; ; ; ; ; ; ; ; ;#;#;#;#;#;#;#;#;#;#;#;#;#;#
#;#;#; ; ; ; ; ; ; ; ; ; ; ; ;#;#;#;#;#;#;#;#;#;#;#;#;#;#;#;#;#; ; ; ; ; ; ; ; ; ; ; ; ; ; ; ; ; ; ; ; ; ; ; ;#;#;#;#;#;#;#;#;#;#;#;#;#;#
#;#;#; ; ; ; ; ; ; ; ; ; ; ; ;#;#;#;#; ; ; ; ; ; ; ; ; ;#;#;#;#; ; ; ; ; ; ; ; ; ; ; ; ; ; ; ; ; ; ; ; ; ; ; ;#;#;#;#;#;#;#;#;#;#;#;#;#;#
#;#;#; ; ; ; ; ; ; ; ; ; ; ; ;#;#; ; ; ; ; ; ; ; ; ; ; ; ; ;#;#; ; ; ; ; ; ; ;#;#;#;#;#;#; ; ; ; ; ; ; ; ; ; ;#;#;#;#;#;#;#;#;#;#;#;#;#;#
#;#;#; ; ; ; ; ; ; ; ; ; ; ; ; ; ; ; ; ; ; ; ; ; ; ; ; ; ; ; ; ; ; ; ; ; ; ; ;#;#;#;#;#;#; ; ; ; ; ; ; ; ; ; ;#;#;#;#;#;#;#;#;#;#;#;#;#;#
#;#;#; ; ; ; ; ; ; ; ; ; ; ; ; ; ; ; ; ; ; ; ; ; ; ; ; ; ; ; ; ; ; ; ; ; ; ; ; ; ; ; ; ; ; ; ; ; ; ; ; ; ; ; ;#;#;#;#;#;#;#;#;#;#;#;#;#;#
#;#;#; ; ; ; ; ; ; ; ; ; ; ; ; ; ; ; ; ; ; ; ; ; ; ; ; ; ; ; ; ; ; ; ; ; ; ; ; ; ; ; ; ; ; ; ; ; ; ; ; ; ; ; ;#;#;#;#;#;#;#;#;#;#;#;#;#;#
#;#;#; ; ; ; ; ; ; ; ; ; ; ; ; ; ; ; ; ; ; ; ; ; ; ; ; ; ; ; ; ; ; ; ; ; ; ; ; ; ; ; ; ; ; ; ; ; ; ; ; ;s;s;s;#;#;#;#;#;#;#;#;#;#;#;#;#;#
#;#;#; ; ; ; ; ; ; ; ; ; ; ; ; ; ; ; ; ; ; ; ; ; ; ; ; ; ; ; ; ; ; ; ; ; ; ; ; ; ; ; ; ; ; ; ; ; ;#;#;#;#;#;#;#;#;#;#;#;#;#;#;#;#;#;#;#;#
#;#;#; ; ; ; ; ; ; ; ; ; ; ; ; ; ; ; ; ; ; ; ; ; ; ; ; ; ; ; ; ; ; ; ; ; ; ; ; ; ; ; ; ; ; ; ; ; ;#;#;#;#;#;#;#;#;#;#;#;#;#;#;#;#;#;#;#;#
#;#;#; ; ; ; ; ; ; ; ; ; ; ; ; ; ; ; ; ; ; ; ; ; ; ; ; ; ; ; ; ; ; ; ; ; ; ; ; ; ; ; ; ; ; ; ; ; ; ; ; ;#;#;#;#;#;#;#;#;#;#;#;#;#;#;#;#;#
#;#;#; ; ; ; ; ; ; ; ; ; ; ; ; ; ; ; ; ; ; ; ; ; ; ; ; ; ; ; ; ; ; ; ; ; ; ; ; ; ; ; ; ; ; ; ; ; ; ; ; ; ; ;#;#;#;#;#;#;#;#;#;#;#;#;#;#;#
#;#;#; ; ; ; ; ; ; ; ; ; ; ; ; ; ; ; ; ; ; ; ; ; ; ; ; ; ; ; ; ; ; ; ; ; ; ; ; ; ; ; ; ; ; ; ; ; ; ; ; ; ; ; ;#;#;#;#;#;#;#;#;#;#;#;#;#;#
#; ; ; ; ; ; ; ; ; ; ; ; ; ; ; ; ; ; ; ; ; ; ; ; ; ; ; ; ; ; ; ; ; ; ; ; ; ; ; ; ; ; ; ; ; ; ; ; ; ; ; ; ; ; ;#;#;#;#;#;#;#;#;#;#;#;#;#;#
#; ; ; ; ; ; ; ; ; ; ; ; ; ; ; ; ; ; ;#;#;#;#;#;#;#; ; ; ; ; ; ; ; ; ; ; ; ; ; ; ;#;#;#;#;#;#;#;#;#;#;#;#;#;#;#;#;#;#;#;#;#;#;#;#;#;#;#;#
#;Transition|v|2; ; ; ; ; ; ; ; ; ; ; ; ; ; ; ;#;#;#;#;#;#;#;#;#; ; ; ; ; ; ; ; ; ; ; ; ; ; ; ;#;#;#;#;#;#;#;#;#;#;#;#;#;#;#;#;#;#;#;#;#;#;#;#;#;#;#;#
#; ; ; ; ; ; ; ; ; ; ; ; ; ; ;#;#;#;#;#;#;#;#;#;#;#; ; ; ; ; ; ; ; ; ; ; ; ; ; ; ;#;#;#;#;#;#;#;#;#;#;#;#;#;#;#;#;#;#;#;#;#;#;#;#;#;#;#;#
#; ; ; ; ; ; ;@; ; ; ; ; ;#;#;#;#;#;#;#;#;#;#;#;#;#;s;s;s;s;s;s;s;s;s;s;s;s;s;s;s;#;#;#;#;#;#;#;#;#;#;#;#;#;#;#;#;#;#;#;#;#;#;#;#;#;#;#;#
#;#;#;#;#;#;#;#;#;#;#;#;#;#;#;#;#;#;#;#;#;#;#;#;#;#;#;#;#;#;#;#;#;#;#;#;#;#;#;#;#;#;#;#;#;#;#;#;#;#;#;#;#;#;#;#;#;#;#;#;#;#;#;#;#;#;#;#;#
