#;#;#;#;#;#;#;#;#;#;#;#;#;#;#;#;#;#;#;#;#;#;#;#;#;#;#;#;#;#
#; ; ; ; ; ; ; ; ; ; ; ; ; ; ; ; ; ; ; ; ; ; ; ; ; ; ; ; ;#
#; ; ; ; ; ; ; ; ; ; ; ; ; ; ; ; ; ; ; ; ; ; ; ; ; ; ; ; ;#
#; ; ; ; ; ; ; ; ; ; ; ; ; ; ; ; ; ; ; ; ; ; ; ; ; ; ; ; ;#
#; ; ; ; ; ; ; ; ; ; ; ; ; ; ; ; ; ; ; ; ; ; ; ; ; ; ; ; ;#
#; ; ; ; ; ; ; ; ; ; ; ; ; ; ; ; ; ; ; ; ; ; ; ; ; ; ; ; ;#
#; ; ; ; ; ; ; ; ; ; ; ; ; ; ; ; ; ; ; ; ; ; ; ; ; ; ; ; ;#
#; ; ; ; ; ; ; ; ; ; ; ; ; ; ; ; ; ; ; ; ; ; ; ; ; ; ; ; ;#
#; ; ; ; ; ; ; ; ; ; ; ; ; ; ; ; ; ; ; ; ; ; ; ; ; ; ; ; ;#
#; ; ; ; ; ; ; ; ; ; ; ; ; ; ; ; ;#;#; ; ; ; ; ; ; ; ; ; ;#
#; ; ; ; ; ; ; ; ; ;#;#; ; ; ; ; ;#;#; ; ; ; ; ; ; ; ; ; ;#
#; ; ; ; ; ; ; ; ; ;#;#; ; ; ; ; ;#;#; ; ; ; ; ; ; ; ; ; ;#
#; ; ; ; ; ; ; ; ; ;#;#; ; ; ; ; ;#;#; ; ; ; ; ; ; ; ; ; ;#
#; ; ; ; ; ; ; ; ; ;#;#; ; ; ; ; ; ; ; ; ; ; ; ; ; ; ; ; ;#
#; ; ; ; ; ; ; ; ; ; ; ; ; ; ; ; ; ; ; ; ; ; ; ; ; ; ; ; ;#
#; ; ; ; ; ; ; ; ; ; ; ; ; ; ; ; ; ; ; ; ; ; ; ; ; ; ; ; ;#
#; ; ; ; ; ; ; ; ; ; ; ; ; ; ; ; ; ; ; ; ; ; ; ; ; ; ; ; ;#
#; ; ; ; ; ;#; ; ; ; ; ; ; ; ; ; ; ; ; ; ; ;#;#; ; ; ; ; ;#
#; ; ; ; ; ;#;#; ; ; ; ; ; ; ; ; ; ; ; ; ;#;#;#; ; ; ; ; ;#
#; ; ; ; ; ;#;#;#; ; ; ; ; ; ; ; ; ; ; ;#;#;#; ; ; ; ; ; ;#
#; ; ; ; ; ; ;#;#;#; ; ; ; ; ; ; ;#;#;#;#;#; ; ; ; ; ; ; ;#
#; ; ; ; ; ; ; ;#;#;#;#;#;#;#;#;#;#;#;#;#;#; ; ; ; ; ; ; ;#
#; ; ; ; ; ; ; ;#;#;#;#;#;#;#;#;#;#;#;#; ; ; ; ; ; ; ; ; ;#
#; ; ; ; ; ; ; ; ; ; ; ;#;#;#;#;#;#; ; ; ; ; ; ; ; ; ; ; ;#
#; ; ; ; ; ; ; ; ; ; ; ; ; ; ; ; ; ; ; ; ; ; ; ; ; ; ; ; ;#
#; ; ; ; ; ; ; ; ; ; ; ; ; ; ; ; ; ; ; ; ; ; ; ; ; ; ; ; ;#
#;Transition|v|3; ; ; ; ; ; ; ; ; ; ; ; ; ; ; ; ; ; ; ; ; ; ; ; ; ; ; ;#
#; ; ; ; ; ; ; ; ; ; ; ; ; ; ; ; ; ; ; ; ; ; ; ; ; ; ; ; ;#
#; ; ; ; ; ; ; ; ; ; ; ; ; ; ; ; ; ; ; ; ; ; ; ; ; ; ; ; ;#
#;#;#;#;#;#;#;#;#;#;#;#;#;#;#;#;#;#;#;#;#;#;#;#;#;#;#;#;#;#
