#;#;#;#;#;#;#;#;#;#;#;#;#;#;#;#;#;#;#;#;#;#;#;#;#;#;#;#;#;#;#
#;#;#;#;#;#;#;#;#;#;#; ; ; ; ; ; ; ; ; ; ; ; ; ; ;#;#;#;#;#;#
#;#;#;#;#;#;#; ; ; ; ; ; ; ; ; ; ; ; ; ; ; ; ; ; ; ; ;#;#;#;#
#;#;#;#;#; ; ; ; ; ; ; ; ; ; ; ; ; ; ; ; ; ; ; ; ; ; ; ;#;#;#
#;#;#; ; ; ; ; ; ; ; ; ; ; ; ; ; ; ; ; ; ; ; ; ; ; ; ; ; ;#;#
#;#;#; ; ; ; ; ; ; ; ; ; ; ; ; ; ; ; ; ; ; ; ; ; ; ; ; ; ; ;#
#; ; ; ; ; ; ; ; ; ; ; ; ; ; ; ; ; ; ; ; ; ; ; ; ; ; ; ; ; ;#
#; ; ; ; ; ; ; ; ; ; ; ; ; ; ; ; ; ; ; ; ; ; ; ; ; ; ; ; ; ;#
#;Transition|v|2; ; ; ; ; ; ; ; ; ; ; ; ; ; ; ; ; ; ; ; ; ; ; ; ; ; ; ; ;#
#; ; ; ; ; ; ; ; ; ; ; ; ; ; ; ; ; ; ; ; ; ; ; ; ; ; ; ; ; ;#
#; ; ; ; ; ; ; ; ; ; ; ; ; ; ; ; ; ; ; ; ; ; ; ; ; ;@; ; ; ;#
#;#;#;#;#;#;#;#;#;#;#;#;#;#;#;#;#;#;#; ; ; ; ; ;#;#;#;#;#;#;#
#;#;#;#;#;#;#;#;#;#;#;#;#;#;#;#;#;#;#; ; ; ; ; ;#;#;#;#;#;#;#
#;#;#;#;#;#;#;#;#;#;#;#;#;#;#;#;#;#;#; ; ;Transition|h|1; ; ;#;#;#;#;#;#;#
#;#;#;#;#;#;#;#;#;#;#;#;#;#;#;#;#;#;#;#;#;#;#;#;#;#;#;#;#;#;#
