#;#;#;#;#;#;#;#;#;#;#;#;#;#;#;#;#;#;#;#
#;#;#;#;#;#;#;#;#;#;#;#;#;#;#;#;#;#;#;#
#;#; ; ; ; ; ; ; ; ; ; ; ; ; ; ; ; ; ;#
#;#; ; ; ; ; ; ; ; ; ; ; ; ; ; ; ; ; ;#
#;#; ; ; ; ; ; ; ; ; ; ; ; ; ; ; ; ; ;#
#;#; ; ; ; ; ; ; ; ; ; ; ; ; ; ; ; ; ;#
#;#; ; ; ; ; ; ; ; ; ; ; ; ; ; ; ; ; ;#
#;#; ; ; ; ;#;#;#;#;#;#;#;#;#;#;#;#;#;#
#;#; ; ; ; ; ; ; ; ; ; ; ; ; ; ; ; ;#;#
#;#; ; ; ; ; ; ; ; ; ; ; ; ; ; ; ; ;#;#
#;#; ; ; ; ; ; ; ; ; ; ; ; ; ; ; ; ;#;#
#;#; ; ; ; ; ; ; ; ; ; ; ; ; ; ; ; ;#;#
#;#; ; ; ; ; ; ; ; ; ; ; ; ; ; ; ; ;#;#
#;#;#;#;#;#;#;#;#;#;#;#;#;#; ; ; ; ;#;#
#; ; ; ; ; ; ; ; ; ; ; ; ; ; ; ; ; ;#;#
#; ; ; ; ; ; ; ; ; ; ; ; ; ; ; ; ; ;#;#
#; ; ; ; ; ; ; ; ; ; ; ; ; ; ; ; ; ;#;#
#; ; ; ;@; ; ; ; ; ; ; ; ; ; ; ; ; ;#;#
#;#;#;#;#;#;#;#;#;#;#;#;#;#;#;#;#;#;#;#
#;#;#;#;#;#;#;#;#;#;#;#;#;#;#;#;#;#;#;#
