#;#;#;#;#;#;#;#;#;#;#;#;#;#;#;#;#;#;#;#
#; ; ; ; ; ; ; ; ; ; ; ; ; ; ; ; ; ; ;#
#; ; ; ; ; ; ; ; ; ; ; ; ; ; ; ; ; ; ;#
#; ; ; ; ; ; ; ; ; ; ; ; ; ; ; ; ; ; ;#
#; ; ; ; ; ; ; ; ; ; ; ; ; ; ; ; ; ; ;#
#; ; ; ; ; ; ; ; ; ; ; ; ; ; ; ; ; ; ;#
#; ; ; ; ; ; ; ; ; ; ; ; ; ; ; ; ; ; ;#
#; ; ; ; ; ; ; ; ; ; ; ; ; ; ; ; ; ; ;#
#; ; ; ; ; ; ; ; ; ; ; ; ; ; ; ; ; ; ;#
#; ; ; ; ; ; ; ; ; ; ; ; ; ; ; ; ; ; ;#
#; ; ; ; ; ; ; ; ; ; ; ; ; ; ; ; ; ; ;#
#; ; ; ; ; ; ; ; ; ; ; ; ; ; ; ; ; ; ;#
#; ; ; ; ; ; ; ; ; ; ; ; ; ; ; ; ; ; ;#
#; ; ; ; ; ; ; ; ; ; ; ; ;#;#;#;#;#;#;#
#; ; ; ; ; ; ; ; ; ; ; ; ; ; ; ; ; ; ;#
#; ; ; ; ; ; ; ; ; ; ; ; ; ; ; ; ; ; ;#
#; ; ; ; ; ; ; ; ; ; ; ; ; ; ; ; ; ; ;#
#; ;@; ; ; ; ; ; ; ; ; ; ; ; ; ; ; ; ;#
#; ;#; ;#; ;#; ;#; ;#; ;#; ;#; ;#; ;#;#
#;#;#;#;#;#;#;#;#;#;#;#;#;#;#;#;#;#;#;#
