#;#;#;#;#;#;#;#;#;#;#;#;#;#;#;#;#;#;#;#;#;#;#;#;#;#;#;#;#;#;#;#;#;#;#;#;#;#;#;#;#;#;#;#;#;#;#;#;#;#
#;*;*;*;*;*;*;*;*;*;*;*;*;*;*;*;*;*;*;*;*;*;*;*;*;*;*;*;*;*;*;*;*;*;*;*;*;*;*;*;*;*;*;*;*;*;*;*;*;#
#;*; ; ; ; ; ; ; ; ; ; ; ; ; ; ; ; ; ; ; ; ; ; ; ; ; ; ; ; ; ; ; ; ; ; ; ; ; ; ; ; ; ; ; ; ; ; ;*;#
#;*; ; ; ; ; ; ; ; ; ; ; ; ; ; ; ; ; ; ; ; ; ; ; ; ; ; ; ; ; ; ; ; ; ; ; ; ; ; ; ; ; ; ; ; ; ; ;*;#
#;*; ; ; ; ; ; ; ; ; ; ; ; ; ; ; ; ; ; ; ; ; ; ; ; ; ; ; ; ; ; ; ; ; ; ; ; ; ; ; ; ; ; ; ; ; ; ;*;#
#;*; ; ; ; ; ; ; ; ; ; ; ; ; ; ; ; ; ; ; ; ; ; ; ; ; ; ; ; ; ; ; ; ; ; ; ; ; ; ; ; ; ; ; ; ; ; ;*;#
#;*; ; ; ; ; ; ; ; ; ; ; ; ; ; ; ; ; ; ; ; ; ; ; ; ; ; ; ; ; ; ; ; ; ; ; ; ; ; ; ; ; ; ; ; ; ; ;*;#
#;*; ; ; ; ; ; ; ; ; ; ; ; ; ; ; ; ; ; ; ; ; ; ; ; ; ; ; ; ; ; ; ; ; ; ; ; ; ; ; ; ; ; ; ; ; ; ;*;#
#;*; ; ; ; ; ; ; ; ; ; ; ; ; ; ; ; ; ; ; ; ; ; ; ; ; ; ; ; ; ; ; ; ; ; ; ; ; ; ; ; ; ; ; ; ; ; ;*;#
#;*; ; ; ; ; ; ; ; ; ; ; ; ; ; ; ; ; ; ; ; ; ; ; ; ; ; ; ; ; ; ; ; ; ; ; ; ; ; ; ; ; ; ; ; ; ; ;*;#
#;*; ; ; ; ; ; ; ; ; ; ; ; ; ; ; ; ; ; ; ; ; ; ; ; ; ; ; ; ; ; ; ; ; ; ; ; ; ; ; ; ; ; ; ; ; ; ;*;#
#;*; ; ;*;*;*;*;*;*;*;*;*;*;*;*;*;*; ; ; ; ; ; ; ; ; ; ; ; ; ; ; ; ; ; ; ; ; ; ; ; ; ; ; ; ; ; ;*;#
#;*; ; ;*;#;#;#;#;#;#;#;#;#;#;#;#;*; ; ; ; ; ; ; ; ; ; ; ; ; ; ; ; ; ; ; ; ; ; ; ; ; ; ; ; ; ; ;*;#
#;*; ; ;*;#;#;#;#;#;#;#;#;#;#;#;#;*; ; ; ; ; ; ; ; ; ; ; ; ; ; ; ; ; ; ; ; ; ; ; ; ; ; ; ; ; ; ;*;#
#;*; ; ;*;#;#; ;#;#;#;#;#;#; ;#;#;*; ; ; ; ; ; ; ; ; ; ; ; ; ; ; ;*;*;*;*;*;*;*;*;*;*; ; ; ; ; ;*;#
#;*; ; ;*;#; ; ; ;#;#;#;#; ; ; ;#;*; ; ; ; ; ; ; ; ; ; ; ; ; ; ; ;*;#;#;#;#;#;#;#;#;*; ; ; ; ; ;*;#
#;*; ; ; ; ; ; ; ; ;#;#; ; ; ; ; ; ; ; ; ; ; ; ; ;@; ; ; ; ; ; ; ;*;#;#;#;#;#;#;#;#;*; ; ; ; ; ;*;#
#;*; ; ; ; ; ; ; ;#;#;#;#; ; ; ; ; ; ; ; ; ;#;#;#;#;#;#;#; ; ; ; ;*;#;*;#;#;#;#;*;#;*; ; ; ; ; ;*;#
#;*; ; ; ; ; ; ; ;#;#;#;#; ; ; ; ; ; ; ; ; ;#;#;#;#;#;#;#; ; ; ; ; ;*; ;*;#;#;*; ;*; ; ; ; ; ; ;*;#
#;*; ; ; ; ; ; ; ; ;#;#; ; ; ; ; ; ; ; ; ; ; ;#; ;#; ;#; ; ; ; ; ; ; ; ; ;*;*; ; ; ; ; ; ; ; ; ;*;#
#;*; ; ; ; ; ; ; ; ; ; ; ; ;*;*;*;*;*; ; ; ; ; ; ;#; ; ; ; ; ; ; ; ; ; ; ; ; ; ; ; ; ; ; ; ; ; ;*;#
#;*; ; ; ; ; ; ; ; ; ; ; ; ;*;#;#;#;*; ; ; ; ; ; ;#; ; ; ; ; ; ; ; ; ; ; ; ; ; ; ; ; ; ; ; ; ; ;*;#
#;*; ; ; ; ; ; ; ; ; ; ; ; ; ;#;#;#; ; ; ; ; ; ; ;#; ; ; ; ; ;*;*;*;*;*;*;*;*; ; ; ; ; ; ; ; ; ;*;#
#;*; ; ; ; ; ; ; ; ; ; ; ; ; ; ;#; ; ; ; ; ; ; ; ;#; ; ; ; ; ;*;#;#;#;#;#;#;*; ; ; ; ; ; ; ; ; ;*;#
#;*; ; ; ; ; ; ; ; ; ; ; ; ; ; ; ; ; ; ; ; ; ; ;#;#;#; ; ; ; ; ;#;#;#;#;#;#; ; ; ; ; ; ; ; ; ; ;*;#
#;*; ; ; ; ; ; ; ; ; ; ; ; ; ; ; ; ; ; ; ; ; ; ; ;#; ; ; ; ; ; ; ;#;#;#;#; ; ; ; ; ; ; ; ; ; ; ;*;#
#;*; ; ; ; ; ; ; ; ; ; ; ; ; ; ; ; ; ; ; ; ; ;#;#;#;#;#; ; ; ; ; ; ;#;#; ; ; ; ; ; ; ; ; ; ; ; ;*;#
#;*; ; ; ; ; ; ; ; ; ; ; ; ; ; ; ; ; ; ; ; ; ; ; ;#; ; ; ; ; ; ; ; ; ; ; ; ; ; ; ; ; ; ; ; ; ; ;*;#
#;*; ; ; ; ; ; ; ; ; ; ; ; ; ; ; ; ; ; ; ; ; ; ; ;#; ; ; ; ; ; ; ; ; ; ; ; ; ; ; ; ; ; ; ; ; ; ;*;#
#;*; ; ; ; ; ; ; ; ; ; ; ; ; ; ; ; ; ; ; ; ; ; ; ;#; ; ; ; ; ; ; ; ; ; ; ; ; ; ; ; ; ; ; ; ; ; ;*;#
#;*; ; ; ; ; ; ; ; ; ; ; ; ; ; ; ; ; ; ; ; ; ; ; ;#; ; ; ; ; ; ; ; ; ; ; ; ; ; ; ; ; ; ; ; ; ; ;*;#
#;*; ; ; ; ; ; ; ; ; ; ; ; ; ; ; ; ; ; ; ; ; ; ; ;#; ; ; ; ; ; ; ; ; ; ; ; ; ; ; ; ; ; ; ; ; ; ;*;#
#;*; ; ; ; ; ; ; ; ; ; ; ; ; ; ; ; ; ; ; ; ;#;#;#;#;#;#;#; ; ; ; ; ; ; ; ; ; ; ; ; ; ; ; ; ; ; ;*;#
#;*; ; ; ; ; ; ; ; ; ; ; ; ; ; ; ; ; ; ; ; ; ; ; ;#; ; ; ; ; ; ; ; ; ; ; ; ; ; ; ; ; ; ; ; ; ; ;*;#
#;*; ; ; ; ; ; ; ; ; ; ; ; ; ; ; ; ; ; ; ;#;#;#;#;#;#;#;#;#; ; ; ; ; ; ; ; ; ; ; ; ; ; ; ; ; ; ;*;#
#;*; ; ; ; ; ; ; ; ; ; ; ; ; ; ; ; ; ; ; ; ; ; ; ;#; ; ; ; ; ; ; ; ; ; ; ; ; ; ; ; ; ; ; ; ; ; ;*;#
#;*; ; ; ; ; ; ; ; ; ; ; ; ; ; ; ; ; ; ; ; ; ; ; ;#; ; ; ; ; ; ; ; ; ; ; ; ; ; ; ; ; ; ; ; ; ; ;*;#
#;*; ; ; ; ; ; ; ; ; ; ; ; ; ; ; ; ; ; ; ; ; ; ; ;#; ; ; ; ; ; ; ; ; ; ; ; ; ; ; ; ; ; ; ; ; ; ;*;#
#;*; ; ; ; ; ; ; ; ; ; ; ; ; ; ; ; ; ; ; ; ; ; ; ;#; ; ; ; ; ; ; ; ; ; ; ; ; ; ; ; ; ; ; ; ; ; ;*;#
#;*; ; ; ; ; ; ; ; ; ; ; ; ; ; ; ; ; ; ; ; ; ; ; ;#; ; ; ; ; ; ; ; ; ; ; ; ; ; ; ; ; ; ; ; ; ; ;*;#
#;*; ; ; ; ; ; ; ; ; ; ; ; ; ; ; ; ; ; ;#;#;#;#;#;#;#;#;#;#;#; ; ; ; ; ; ; ; ; ; ; ; ; ; ; ; ; ;*;#
#;*; ; ; ; ; ; ; ; ; ; ; ; ; ; ; ; ; ; ; ; ; ; ; ;#; ; ; ; ; ; ; ; ; ; ; ; ; ; ; ; ; ; ; ; ; ; ;*;#
#;*; ; ; ; ; ; ; ; ; ; ; ; ; ; ; ; ; ;#;#;#;#;#;#;#;#;#;#;#;#;#; ; ; ; ; ; ; ; ; ; ; ; ; ; ; ; ;*;#
#;*; ; ; ; ; ; ; ; ; ; ; ; ; ; ; ; ; ; ; ; ; ; ; ;#; ; ; ; ; ; ; ; ; ; ; ; ; ; ; ; ; ; ; ;*;*;*;*;#
#;*; ; ; ; ; ; ; ; ; ; ; ; ; ; ; ; ; ; ; ; ; ; ; ;#; ; ; ; ; ; ; ; ; ; ; ; ; ; ; ; ;*;*;*;*;#;#;#;#
#;*; ; ; ; ; ; ; ; ; ; ; ; ; ; ; ; ; ; ; ; ; ; ; ;#; ; ; ; ; ; ; ; ; ; ; ; ; ; ; ;*;*;#;#;#;#;#;#;#
#;*; ; ; ; ; ; ; ; ; ; ; ; ; ; ; ; ; ; ; ; ; ; ; ;#; ; ; ; ; ; ; ; ; ; ; ; ;*;*;*;*;#;#;#;#;#;#;#;#
#;*; ; ; ; ; ; ; ; ; ; ; ; ; ; ; ; ; ; ; ; ; ; ; ;#; ; ; ; ; ; ; ; ; ; ;*;*;*;#;#;#;#;#;#;#;#;#;#;#
#;*;*;*;*;*;*;*;*;*;*;*;*;*;*;*;*;*;*;*;*;*;*;*;*;*;*;*;*;*;*;*;*;*;*;*;*;#;#;#;#;#;#;#;#;#;#;#;#;#
#;#;#;#;#;#;#;#;#;#;#;#;#;#;#;#;#;#;#;#;#;#;#;#;#;#;#;#;#;#;#;#;#;#;#;#;#;#;#;#;#;#;#;#;#;#;#;#;#;#
