###########################################################
#.........................................................#
#.........................................................#
#.........................................................#
#.........................................................#
#..............###...................###..................#
#..............###...................###..................#
#..............###...................###..................#
#.........................................................#
#............##.........................##................#
#.............##.......................##.................#
#..............##.....................##..................#
#...............###.................###...................#
#.................####....@......####.....................#
#...................###############.......................#
#.........................................................#
#.........................................................#
#.........................................................#
#.........................................................#
#.........................................................#
###########################################################
