##############################
#............................#
#............................#
#............................#
#............................#
#............................#
#............................#
#............................#
#v02.........................#
#............................#
#...........@................#
####################.....#####
#..................#.....#...#
#..................#.h01.#...#
##############################