######
#    #
#    #
#    #
#    #
##   #
#    #
#   ##
#    #
#v01 #
######
